ally	đồng minh
and	và
bad	tồi
beautiful	đẹp
bird	con chim
bye	tạm biệt
computer	máy tính
end	kết thúc
evening	buổi chiều
fan	quạt
fast	nhanh
father	bố
good	tốt
hello	xin chào
high	cao
love	yêu
math	toán học
morning	buổi sáng
mother	mẹ
new	mới
night	buổi tối
old	cũ
phone	điện thoại
short	ngắn
sleep	ngủ
son	con trai
technology	công nghệ
tiger	con hổ
